####################
#..................#
#.#.#.#.#.#.#.#.#.#
#..................#
####################